###############################O##
#                                #
#                                #
#                                #
#                                #
#                                #
#                                #
#                                #
#                                #
#                                #
#                                #
#                    #############
#              ##### #           #
#              #   # #           #
#              # # # #           #
#              # # # #           #
#              # #####           #
#                                #
######### ########################
#                                #
#                                #
#                                #
#                                #
#                                #
#                                #
#                                #
#                                #
#                                #
#                                #
#                    #############
#              ##### #           #
#              #   # #           #
#              # # # #           #
#              # # # #           #
#              # #####           #
#                                #
############################### ##
#                                #
#                                #
#                                #
#                                #
#                                #
#                                #
#                                #
#                                #
#                                #
#                                #
#                    #############
#              ##### #           #
#              #   # #           #
#              # # # #           #
#              # #   #           #
#              # #####           #
#              #                 #
########################## #######
#                                #
#                                #
#                                #
#                                #
#                                #
#                                #
#                                #
#                                #
#                                #
#                                #
#                    #############
#              ##### #          X#
#              #   # #           #
#              # # # #           #
#              # # # #           #
#              # #####           #
#                                #
##################################